
سرزمین: یکی از اشکال استعمار، قبل از مستعمره
تفریط: کوتاهی در کار
توازن: تعادل، برابری
جنون: شیفتگی، شیدایی، شوریدگی
چنبره زدن: حلقه زدن، جمع شدن
خصال: خوی‌ها، نیک یا بد
دار السلطنه: پایتخت در صفویه و قاجار، شهر شاهزاده
درایت: آگاهی، دانش، بینش
زبونی: فرومایگی، درماندگی
زنبورک: توپ جنگی کوچک، زمان صفویه و قاجاریه
شایق: آرزومند، مشتاق
صفیر: صدای بلند و تیز
طاقت فرسا: سخت، تحمل ناپذیر
غیرت: حمیت، تعصب
کورسو: نور اندک، روشنایی کم
معبد: پرستشگاه، محل عبادت
مقرر: معلوم، تعیین شده
موعد: هنگام، زمان
موزون: هماهنگ، خوش نوا
نهیب: فریاد بلند، برای ترساندن یا اخطار
وجد: سرور، شادمانی، خوشی
ولایات: مجموعه شهرها، معادل شهرستان

خزاین: گنجینه‌ها
خلیفت: خلیفه، جانشین
رافت: مهربانی، شفقت
ربوبیت: الوهیت، خدایی، پروردگاری
رغبت: میل، اراده، خواست
سست: بی اراده، بی غیرت
طوع: فرمان برداری، اطاعت
عنایت: توجه، لطف، احسان
غنا: بی نیازی، توانگری
قبضه: یک مشت از هر چیزی
قرب: نزدیک شدن، هم جواری
کبریایی: منسوب به کبریا، خداوند تعالی
متلالی: درخشان، تابان
مذلت: فرومایگی، خواری
مشتبه: اشتباه کننده
مشعشع: درخشان، تابان
مقرب: نزدیک به کسی، منزلت یافته
ملکوت: عالم غیب، جهان بالا
نفایس: چیزهای نفیس و گران بها
وسائط: آنچه به مقصود می‌رسند
هیئت: شکل ظاهر، دسته‌ای از مردم

پالیز: باغ، جالیز
تحفه: ارمغان، هدیه
تمکن: توانگری، ثروت
تهنیت: شادباش، تبریک
چابک: تند و فرز
دستخوش: در معرض، بازیچه
سبک سری: سهل انگاری، بی مسئولیتی
شاب: برنا، جوان
شائبه: شک، عیب، نقص
شعر تمثیلی: شعر نمادین، آمیخته به مثل
صباحت: زیبایی، جمال
عندلیب: بلبل، هزار دستان
فرخنده: مبارک، خجسته
فرط: بسیاری
گیوه: کفش با رویه دست باف
لطایف: نکته‌های دقیق، سخنان نرم
لفاف: پارچه، کاغذ که بر چیزی پیچند
متعصب: غیرتمند
مسرت: شادی، خوشی
مسرور: شادمان، خشنود
مشیت: اراده، خواست
میثاق: عهد، پیمان
نکبت بار: شوم، ایجاد کننده بدبختی
نمد: پارچه کلفت، بالاپوش نمدی

وادی: سرزمین
ولی: دارنده بالاترین مقام، دوست
همپا: همراه، هم قدم
انکار: باور نکردن، نپذیرفتن
بیعت: پیمان، عهد، فرمان برداری
چنبر: حلقه، قلاده
رستن: رها شدن، نجات یافتن
روحانی: منسوب به روح معنوی
سیمینه: منسوب به سیم، اشیای نقره
مدار: مسیر دایره‌ای، چرخش
مرهم: داروی زخم، التیام بخش
منکر: انکار کننده، ناباور
آوری: بی گمان، به طور قطع
اژدها پیکر: در شکل اژدها، دارای نقش اژدها
اساطیر: افسانه‌ها، داستانهای خدایان
محضر: استشهاد نامه، متن امضا بزرگان
موبد: روحانی زردشتی، دانشمند
نفیر: صدای بلند، فریاد
هنر: فضیلت، استعداد، لیاقت
یکا: یک ناگهان

آوردگاه: میدان جنگ، نبردگاه
ابرش: اسب خال دار، در اینجا اسب
امتناع: سرباز زدن از کاری، خودداری
برافراختن: بلند کردن
پور: فرزند مذکر، پسر
تپیدن: بی قراری، لرزیدن از ترس
حبیب: دوستدار، یار
حرب: جنگ، نزاع
تعاون: یاری کردن
تکفل: عهده دار شدن
تگ: دویدن
تیمار: مواظبت، مراقبت
ثقت: اطمینان، خاطر جمعی
جال: دام، تور
حبه: دانه
خایب: ناامید، بی بهره
دها: زیرکی، هوشمندی
راه تافتن: تغییر مسیر دادن
رخصت: اجازه، اذن دادن
ریاحین: گیاهان خوشبو
زمرد: سنگ قیمتی، سبز
زهاب: آبی که از سنگی جوشد، اشک
ستیزه: روی گستاخ، پررو
سر: رئیس
سیادت: سروری، بزرگی
شکاری: منسوب به شکار، صید
صافی: پاک، بیغش، خالص
صواب: صلاح، درست
طاعن: سرزنشگر، عیب جو
عقده: گره
قفا: پشت گردن، دنبال
گرازان: در حال گرازیدن، خرامان
گشن: انبوه، پرشاخ و برگ
متصید: شکارگاه
متواتر: پی در پی
مجادله: جدال، ستیزه
مطاوعت: فرمان بری

تأثر: اثر پذیری، اندوه
تعلیمی: عصای سبک
تلمذ: شاگردی کردن، آموختن
چرتکه: وسیله محاسبه، جمع و تفریق
چله: زه کمان، پرتاب
رفعت: اوج، بلندی، والایی
سو: دید، توان بینایی
شماتت: سرکوفت، سرزنش، ملامت
شوربا: آش ساده، برنج و سبزی
صورتک: چهره مصنوعی، نقاب
عیار: خالص، سنجه
فرام: فریم، قاب عینک
فرنگی مآب: آداب اروپاییان رفتار
فرنگی مابی: به شیوه فرنگی‌ها
قداره: جنگ افزار، قداره کش
قلا: کمین، قلا کردن کمین کردن
قوال: بازیگر نمایشهای دوره گردی
گذا: آن چنانی، چنان
کلون: قفل چوبی، بستن در
کمیسیون: هیئت بررسی، جلسه
متجددانه: نوگرایانه، روشنفکرانه
محقر: کوچک، حقیر
مخاطره: خطر، خود را در خطر انداختن
مسامحه: آسان گرفتن
مسحور: مفتون، شیفته، مجذوب
مشروعیت: منطبق بودن رویه‌ها، حکومت
مضحک: خنده آور، مسخره آمیز
مغتنم: با ارزش، غنیمت شمرده
مهملی: بی کاری، تنبلی
موقر: با وقار، متین
مهیب: سهمگین، ترس آور
نخ قند: نخ الیاف کنف
هفت صندوقی: گروه‌های نمایشی دوره گردی

ستایش: لطف خدا
ادبار: بدبختی، سیه روزی
اقبال: خوشبختی، سعادت
توفیق: اسباب موافق، نتیجه
تیره رایی: بداندیشی، گمراهی
چاشنی: برای اثر بخشی کلام
حلاوت: شیرینی
نژند: خوار و زبون
گنج: همت
جیب: گریبان، یقه
چنگ: نوعی ساز، خمیده و تارها
حمیت: غیرت، جوانمردی
دغل: ناراست، حیله گر
دون همت: کوتاه همت، طبع پست
زنخدان: چانه
شغال: جانور پستاندار، تیره سگان
شل: دست و پا از کار افتاده
شوریده رنگ: آشفته حال
زر پاره: قراضه، خرده زر
سبحان الله: پاک و منزه‌است خدا
ستدن: ستاندن، دریافت کردن
سرسام: تورم سر و مغز
سور: جشن
شبگیر: سحرگاه، پیش از صبح
شراع: سایه بان خیمه
صعب: دشوار، سخت
صلت: انعام، جایزه، پاداش
ضیعت: زمین زراعتی
عارضه: حادثه، بیماری
علت: بیماری
عز و جل: عزیز و بزرگ و ارجمند
عقد: گردن بند
غرامت زده: تاوان زده، پشیمان
غزو: جنگ کردن با کافران
فارغ شدن: آسوده شدن از کار
فراخ تر: آسوده تر، راحت تر
فراغ: آسایش، آسودگی
فرود: سرای اندرونی، اتاق
فیروزه فام: به رنگ فیروزه
قضا: تقدیر، سرنوشت
کافی: با کفایت، لایق
کران: ساحل، کنار
کراهیت: ناپسندی
کوشک: ساختمان زیبا، قصر

خرگه: خرگاه، خیمه
دمار از کسی کشیدن: نابود کردن کسی
سیماب گون: به رنگ جیوه
گران: سنگین، عظیم
اذن: اجازه، رخصت
اعطا: واگذاری، بخشش
افراط: از حد در گذشتن، زیاده روی
التهاب: شعله ور شدن، ناآرامی
بختک: موجود خیالی، کابوس
تحت الحمایگی: تحت الحمایه بودن، حمایت
پرورده: پرورش یافته
جمله: همه، سراسر
جهانگیر: گیرنده عالم، فتح کننده
جهد: کوشش، تلاش، سعی
چاره گری: تدبیر، مصلحت اندیشی
خنیده: مشهور، معروف، نامدار
خویشان: جمع خویش، اقوام
رایت: بیرق، پرچم، درفش
سرشت: فطرت، آفرینش، طبع
غایت: پایان، فرجام، نهایت
گزاف کاری: زیاده روی، بیهوده کاری
محمل: کجاوه که بر شتر بندند
موسم: زمان، هنگام
استحقاق: سزاواری، شایستگی
اصناف: جمع صنف، انواع
اعزاز: بزرگداشت، گرامیداشت
الوهیت: خدایی، خداوندی
بعد: دوری، فاصله
تعبیه کردن: قرار دادن، جاسازی
تلبیس: حقیقت را پنهان کردن
جلت: بزرگ است، خداوند
الحاح: اصرار، پافشاری
بازارگاه: جای خرید و فروش، اهل بازار
پایمردان: دیو دستیاران، توجیه کنندگان
پشت پا: روی پا، سینه پا
ترگ: کلاه خود
تفرج: گشت و گذار، تماشا
خجسته: فرخنده، مبارک
خوالیگر: آشپز
درفش: پرچم، بیرق
درفش کاویان: درفش ملی ایران
دژم: خشمگین
زخم درای: ضربه پتک
سپردن: پایمال کردن
سپهبد: فرمانده سپاه، سردار
سبک: سریع، شتابان
سروش: فرشته پیام آور
شمار گرفتن: حساب پس دادن
غو: فریاد، بانگ، خروش
فایق: دارای برتری، مسلط
فریاد خواندن: طلب یاری کردن
گرز گاوسر: سری که شبیه سر گاو
گیهان خدیو: خدای جهان
لاف: سخنان بی پایه، ادعا
مجرد: صرف، تنها
خدو: آب دهان، بزاق
دستوری: رخصت دادن، اجازه خواستن
رزمگه: میدان جنگ
ژنده: بزرگ، عظیم
ژیان: خشمناک، خشمگین
سهم: ترس
سهمگین: هراس انگیز
ضرب زدن: کوفتن
غزا: پیکار، جنگ
غضنفر: شیر
قبا: نوعی جامه جلو باز
کیش: آیین، دین، مذهب
کیمیا: ماده‌ای فرضی، فلزات به طلا
منزه: پاک و بی عیب
هژبر: شیر
اختلاف: رفت و آمد
استخلاص: رهایی جستن، رهایی دادن
اعتذار: عذرخواهی، پوزش خواهی
التفات: توجه
امام: راهنما، پیشوا
اولی تر: شایسته تر، سزاوارتر
اهمال: کوتاهی، سهل انگاری
براثر: به دنبال، اثر ردپا
تخلص: رهایی
مطلق: رها شده، آزاد
مطوقه: طوق دار
مظاهرت: یاری کردن، پشتیبانی
معونت: یاری، کمک
ملالت: آزردگی، ضعف و خستگی
ملامت: سرزنش
ملول: سست و ناتوان، آزرده
مناصحت: اندرز دادن، صداقت
منقطع: بریده، قطع شده
مواجب: وظایف و اعمال
مواضع: جای‌ها
موافق: همراه، هم فکر
موالات: دوستی و پیوستگی
مودت: دوستی، محبت
ناحیت: ناحیه، سرزمین
نزه: با صفا، خوش آب و هوا
همگنان: همگان، همه
ورطه: مهلکه، خطر
وقیعت: بدگویی، سرزنش
ابلاغ: رساندن پیام
ارک: قلعه، دژ
بر و بر: با دقت، خیره خیره
بور شدن: شرمنده شدن
زهد: پارسایی، پرهیزگاری
شبگرد: شبرو
شریعت: شرع، آیین، راه دین
صنم: بت، معشوق، زیبارو
عازم: رهسپار، راهی
قدس الله روحه العزیز: خداوند، روح پاک
متفق: همسو، هم عقیده
محضر: محل حضور، مجلس درس
مرشد: راهنما و هدایت کننده
ملک: فرشته
مناسک: اعمال عبادی، آیین‌های دینی
وعظ: اندرز، پند دادن
آغوز: اولین شیر، مواد مقوی
آماس: ورم، تورم
استسقا: مرضی که بیمار، آب بسیار
انعطاف: نرمش، آمادگی
بالبداهه: بدون اندیشه قبلی
بذله گو: شوخ، لطیفه پرداز
به نقد: در حال حاضر
بار: اجازه، پذیرایی عمومی
باره: اسب
برگ: توشه، مایحتاج
تابناک: درخشان، نورانی
جرس: زنگ
جولان: تاخت و تاز
چاووش: پیشاپیش زائران، اشعار مذهبی
خاره سنگ: خارا، سنگ
راهوار: اسب خوش حرکت
رحیل: رفتن، کوچ کردن
رشحه: قطره، چکه
رفت: رفتن، زدودن
رکاب: حلقه فلزی، زین اسب
سترگ: بزرگ، عظیم
علم: پرچم
فرض: واجب گردانیدن
کران: طرف، جهت
کلاف: نخ، ریسمان
محوطه: پهنه، میدانگاه
مشک: انبان، کیسه پوست
نیلی: به رنگ نیل، کبود